0100512006
0101111110
0000100000
0110101011
0310001007
